NO assets/wolftextures1.png
SO assets/wolftextures2.png
WE assets/wolftextures3.png
EA assets/wolftextures4.png

F 25,250,25
C 25,25,250

11111111111111111
10000000000000001
10000000000000001
1N000000000000001
11111111111111111
