NO assets/wolftextures1.png
SO assets/wolftextures2.png
WE assets/wolftextures3.png
EA assets/wolftextures4.png

C 255,255,255
F 64,64,64


1111111111111111111111111 111
1000000000110000000000001 101
1011000001110000000000001 111
1001000000000000000000001
111111111011000001110000111111111
100000000011000001110111111111111
11110111111111000000000010001
11110111111111011101010010001
11000000110101011100000000001
10000000000000000000000010001
10000000000000001101010010001
11000001110101011111011110N0111
11110111 1110101 101111010001
11111111 1111111 111111111111
